##########
#        #
#  ####  #
#        #
#  ####  #
#        #
##########
